16 27
S##########################
                          #
 ############## ######### #
 ######       # ######    #
 ###### ####### ###    ####
                ### # #####
## #### ## #### ### #     #
## #### ## #    ### ##### #
## #### ## ######## #     #
## #### ## ######## # #####
## #### ##          #     #
##      ## ############## #
#### #####          #     #
#### ############## # #####  
####                #       
##########################E

