18 24
S#   #   #   #   #   ###
 # # # # # # # # # # ###
 # # # # # # # # # # ###
   #   #   #       #   #
 ############## ###### #
 ######       # ###### #
 ###### ####### ###    #
                ### # ##
## #### ## #### ### # ##
## #### ## #    ### # ##
## #### ## ######## # ##
## #### ## ######## # ##
## #### ##          # ##
##      ## ########## ##
#### #####          # ##
#### ############## #   
####                ### 
#######################E

