7 7
#######  
S     # 
#     #
#     #
#     #
#     E
#######
